10 10
1 1 1 1 1 1 1 1 1 1
1 0 0 0 0 0 0 0 5 1
1 4 0 0 0 0 0 0 0 1
1 0 0 0 0 0 0 0 0 1
1 0 0 0 20 0 0 0 0 1
1 0 0 0 0 0 0 0 0 1
1 0 0 0 0 0 0 0 4 1
1 0 0 0 21 0 0 0 0 1
1 3 0 0 0 0 0 0 0 1
1 1 1 1 1 1 1 1 1 1