10 10
1 1 1 1 1 1 1 1 1 1
1 0 0 1 0 0 0 0 5 1
1 4 0 1 0 0 25 0 0 1
1 0 0 1 0 1 0 0 0 1
1 0 0 0 20 1 0 0 0 1
1 0 0 0 0 1 0 0 0 1
1 1 1 1 1 1 1 0 4 1
1 0 0 0 0 0 0 0 0 1
1 3 0 0 0 0 0 0 0 1
1 1 1 1 1 1 1 1 1 1